10 10
##########
#........#
#........#
#........#
#...#....#
#...##...#
#........#
#........#
#....#...#
##########
