20 20
####################
#........#.........#
#........#.........#
#........#...###...#
#...#........# #...#
#...##...#...###...#
#........#.........#
#........#.........#
#....#...#.........#
###.###########.####
#..................#
#...###..#...#######
#........#...#.....#
#........#...#.##..#
#..##........#..#..#
#...##...#...###...#
#....#...#.........#
#....##..#.........#
#........#.........#
####################
